{
  "height":12,
  "width":16,
  "maxlevels":5,

  "levels":[
    {
      "level":1,
      "data":[[0,0,0,0,0,0,0,0,0,0,0,0,0,0,0,0],
              [0,0,0,0,0,1,1,1,1,0,0,0,0,0,0,0],
              [0,0,0,1,1,1,4,0,1,1,0,0,0,0,0,0],
              [0,0,0,1,0,3,3,0,0,1,0,0,0,0,0,0],
              [0,0,0,1,0,0,3,0,0,1,0,0,0,0,0,0],
              [0,0,0,1,0,0,0,0,0,1,0,0,0,0,0,0],
              [0,0,0,1,1,1,0,0,0,1,0,0,0,0,0,0],
              [0,0,0,0,0,1,0,0,1,1,0,0,0,0,0,0],
              [0,0,0,0,0,1,2,2,2,1,0,0,0,0,0,0],
              [0,0,0,0,0,1,1,1,1,1,0,0,0,0,0,0],
              [0,0,0,0,0,0,0,0,0,0,0,0,0,0,0,0],
              [0,0,0,0,0,0,0,0,0,0,0,0,0,0,0,0]
              ]
    },
    {
      "level":2,
      "data":[[0,0,0,0,0,0,0,0,0,0,0,0,0,0,0,0],
              [1,1,1,1,0,0,0,0,1,1,1,0,0,0,0,0],
              [1,2,0,1,1,1,0,0,1,4,1,0,0,0,0,0],
              [1,2,0,0,0,1,1,1,1,0,1,1,1,1,0,0],
              [1,2,0,0,0,0,0,1,1,0,1,0,0,1,0,0],
              [1,1,1,0,1,0,0,0,0,0,0,0,3,1,0,0],
              [0,0,1,0,0,0,1,0,1,1,1,1,0,1,1,0],
              [0,1,1,0,1,0,1,0,0,0,0,0,0,0,1,0],
              [0,1,0,3,1,0,1,0,1,0,3,0,0,0,1,0],
              [0,1,0,0,0,0,0,0,0,0,0,0,1,1,1,0],
              [0,1,1,1,1,1,1,1,1,1,1,1,1,0,0,0],
              [0,0,0,0,0,0,0,0,0,0,0,0,0,0,0,0]
      ]
    },
    {
      "level":3,
      "data":[[0,0,0,0,0,0,0,0,0,0,0,0,0,0,0,0],
              [1,1,1,1,1,1,0,0,1,1,1,1,1,1,1,1],
              [1,4,0,0,0,1,1,1,1,0,0,1,0,0,0,1],
              [1,1,1,0,3,0,0,0,1,3,0,0,0,3,0,1],
              [1,2,2,0,0,3,0,0,1,0,0,1,1,1,1,1],
              [1,2,2,0,0,1,0,0,1,3,0,0,0,2,2,1],
              [1,2,2,0,0,1,0,0,1,0,0,0,0,2,2,1],
              [1,1,1,0,0,1,3,0,0,0,0,1,0,1,1,1],
              [1,0,3,3,0,1,0,0,0,3,0,0,0,3,0,1],
              [1,0,0,0,0,1,0,0,1,0,0,0,0,0,0,1],
              [1,1,1,1,1,1,1,1,1,1,1,1,1,1,1,1],
              [0,0,0,0,0,0,0,0,0,0,0,0,0,0,0,0]
      ]
    },
    {
      "level":4,
      "data":[[0,0,0,0,0,0,0,0,0,0,0,0,0,0,0,0],
        [1,1,1,1,1,1,1,1,1,1,1,1,1,1,1,1],
        [1,0,0,0,0,0,0,0,0,0,0,0,0,0,0,1],
        [1,0,0,3,0,3,0,3,0,3,0,3,0,0,0,1],
        [1,0,1,0,1,1,1,1,1,1,1,1,0,1,1,1],
        [1,0,1,0,0,3,0,3,0,1,2,2,2,2,2,1],
        [1,0,1,4,3,0,3,0,3,0,2,0,0,0,2,1],
        [1,0,1,3,0,3,0,3,0,1,2,0,2,0,2,1],
        [1,0,0,0,3,0,3,0,3,0,2,0,0,0,2,1],
        [1,0,1,0,0,0,0,0,0,1,2,2,2,2,2,1],
        [1,1,1,1,1,1,1,1,1,1,1,1,1,1,1,1],
        [0,0,0,0,0,0,0,0,0,0,0,0,0,0,0,0]
      ]
    },
    {
      "level":5,
      "data":[[0,0,0,0,0,0,1,1,1,1,0,1,1,1,1,0],
        [1,1,1,1,1,1,1,0,0,1,1,1,0,0,1,0],
        [1,0,0,2,2,2,1,0,0,0,0,0,3,0,1,0],
        [1,0,1,2,1,1,1,0,0,1,1,1,0,0,1,0],
        [1,0,2,0,0,3,0,0,1,1,1,1,0,1,1,0],
        [1,1,1,0,0,4,0,0,0,0,0,1,0,1,0,0],
        [0,0,1,1,0,1,1,0,0,0,0,1,0,1,0,0],
        [0,0,0,1,0,0,1,1,1,3,1,1,0,1,0,0],
        [0,0,0,1,0,3,1,1,1,0,1,1,0,1,1,0],
        [0,0,0,1,0,0,0,0,0,0,3,0,0,0,1,0],
        [0,0,0,1,1,1,1,1,1,1,1,0,0,0,1,0],
        [0,0,0,0,0,0,0,0,0,0,1,1,1,1,1,0]
      ]
    },
    {
      "level":0,
      "data":[[0,0,0,0,0,0,0,0,0,0,0,0,0,0,0,0],
        [0,0,0,0,0,0,0,0,0,0,0,0,0,0,0,0],
        [0,0,0,0,0,0,0,0,0,0,0,0,0,0,0,0],
        [0,0,0,0,0,0,0,0,0,0,0,0,0,0,0,0],
        [0,0,0,0,0,0,0,0,0,0,0,0,0,0,0,0],
        [0,0,0,0,0,0,0,0,0,0,0,0,0,0,0,0],
        [0,0,0,0,0,0,0,0,0,0,0,0,0,0,0,0],
        [0,0,0,0,0,0,0,0,0,0,0,0,0,0,0,0],
        [0,0,0,0,0,0,0,0,0,0,0,0,0,0,0,0],
        [0,0,0,0,0,0,0,0,0,0,0,0,0,0,0,0],
        [0,0,0,0,0,0,0,0,0,0,0,0,0,0,0,0],
        [0,0,0,0,0,0,0,0,0,0,0,0,0,0,0,0]
      ]
    }


  ]



}